2024-04-22 15:19:34.733925, 12, 6, 6, 0, 0.7272727272727273, 0.36363636363636365, 0.36363636363636365
2024-04-22 15:19:37.484669, 12, 6, 6, 0, 0.0, 0.0, 0.0
2024-04-22 15:19:40.235391, 16, 8, 8, 0, 1.4545454545454546, 0.7272727272727273, 0.7272727272727273
2024-04-22 15:19:42.985953, 16, 8, 8, 0, 0.0, 0.0, 0.0
2024-04-22 15:19:45.736368, 18, 9, 9, 0, 0.7272727272727273, 0.36363636363636365, 0.36363636363636365
2024-04-22 15:19:48.487230, 20, 10, 10, 0, 0.7272727272727273, 0.36363636363636365, 0.36363636363636365
2024-04-22 15:19:51.238222, 20, 10, 10, 0, 0.0, 0.0, 0.0
2024-04-22 15:19:53.989240, 20, 10, 10, 0, 0.0, 0.0, 0.0
2024-04-22 15:19:56.739966, 24, 12, 12, 0, 1.4545454545454546, 0.7272727272727273, 0.7272727272727273
2024-04-22 15:19:59.490530, 24, 12, 12, 0, 0.0, 0.0, 0.0
2024-04-22 15:20:02.241375, 24, 12, 12, 0, 0.0, 0.0, 0.0
2024-04-22 15:20:04.992369, 28, 14, 14, 0, 1.4545454545454546, 0.7272727272727273, 0.7272727272727273
2024-04-22 15:20:07.743427, 28, 14, 14, 0, 0.0, 0.0, 0.0
2024-04-22 15:20:10.494589, 28, 14, 14, 0, 0.0, 0.0, 0.0
2024-04-22 15:20:13.245693, 32, 16, 16, 0, 1.4545454545454546, 0.7272727272727273, 0.7272727272727273
2024-04-22 15:20:15.996720, 32, 16, 16, 0, 0.0, 0.0, 0.0
2024-04-22 15:20:18.747458, 34, 17, 17, 0, 0.7272727272727273, 0.36363636363636365, 0.36363636363636365
2024-04-22 15:20:21.498016, 36, 18, 18, 0, 0.7272727272727273, 0.36363636363636365, 0.36363636363636365
2024-04-22 15:20:24.248603, 36, 18, 18, 0, 0.0, 0.0, 0.0
2024-04-22 15:20:26.999004, 36, 18, 18, 0, 0.0, 0.0, 0.0
2024-04-22 15:20:29.749809, 96, 48, 48, 0, 21.818181818181817, 10.909090909090908, 10.909090909090908
2024-04-22 15:20:32.500709, 206, 103, 103, 0, 40.0, 20.0, 20.0
2024-04-22 15:20:35.251653, 316, 158, 158, 0, 40.0, 20.0, 20.0
2024-04-22 15:20:38.002569, 430, 215, 215, 0, 41.45454545454545, 20.727272727272727, 20.727272727272727
2024-04-22 15:20:40.753176, 540, 270, 270, 0, 40.0, 20.0, 20.0
2024-04-22 15:20:43.504002, 650, 325, 325, 0, 40.0, 20.0, 20.0
2024-04-22 15:20:46.254657, 762, 381, 381, 0, 40.72727272727273, 20.363636363636363, 20.363636363636363
2024-04-22 15:20:49.005501, 874, 437, 437, 0, 40.72727272727273, 20.363636363636363, 20.363636363636363
2024-04-22 15:20:51.756492, 984, 492, 492, 0, 40.0, 20.0, 20.0
2024-04-22 15:20:54.507317, 1098, 549, 549, 0, 41.45454545454545, 20.727272727272727, 20.727272727272727
2024-04-22 15:20:57.258042, 1208, 604, 604, 0, 40.0, 20.0, 20.0
2024-04-22 15:21:00.008801, 1318, 659, 659, 0, 40.0, 20.0, 20.0
2024-04-22 15:21:02.759617, 1432, 716, 716, 0, 41.45454545454545, 20.727272727272727, 20.727272727272727
2024-04-22 15:21:05.510612, 1542, 771, 771, 0, 40.0, 20.0, 20.0
2024-04-22 15:21:08.261361, 1652, 826, 826, 0, 40.0, 20.0, 20.0
2024-04-22 15:21:11.012322, 1766, 883, 883, 0, 41.45454545454545, 20.727272727272727, 20.727272727272727
2024-04-22 15:21:13.763365, 1832, 916, 916, 0, 24.0, 12.0, 12.0
2024-04-22 15:21:16.514105, 1832, 916, 916, 0, 0.0, 0.0, 0.0
2024-04-22 15:21:19.265074, 1836, 919, 917, 2, 1.4545454545454546, 1.0909090909090908, 0.36363636363636365
2024-04-22 15:21:22.015963, 1838, 920, 918, 0, 0.7272727272727273, 0.36363636363636365, 0.36363636363636365
2024-04-22 15:21:24.768397, 1838, 920, 918, 0, 0.0, 0.0, 0.0
2024-04-22 15:21:27.518916, 1842, 922, 920, 0, 1.4545454545454546, 0.7272727272727273, 0.7272727272727273
2024-04-22 15:21:30.269618, 1842, 922, 920, 0, 0.0, 0.0, 0.0
2024-04-22 15:21:33.020517, 1928, 965, 963, 0, 31.272727272727273, 15.636363636363637, 15.636363636363637
2024-04-22 15:21:35.772415, 2042, 1022, 1020, 0, 41.45454545454545, 20.727272727272727, 20.727272727272727
2024-04-22 15:21:38.523433, 2152, 1077, 1075, 0, 40.0, 20.0, 20.0
2024-04-22 15:21:41.274250, 2262, 1132, 1130, 0, 40.0, 20.0, 20.0
2024-04-22 15:21:44.024947, 2373, 1188, 1185, 1, 40.36363636363637, 20.363636363636363, 20.0
2024-04-22 15:21:46.775770, 2486, 1244, 1242, 2, 41.09090909090909, 20.363636363636363, 20.727272727272727
2024-04-22 15:21:49.526270, 2596, 1299, 1297, 2, 40.0, 20.0, 20.0
2024-04-22 15:21:52.277001, 2710, 1356, 1354, 2, 41.45454545454545, 20.727272727272727, 20.727272727272727
2024-04-22 15:21:55.027516, 2820, 1411, 1409, 2, 40.0, 20.0, 20.0
2024-04-22 15:21:57.778055, 2932, 1467, 1465, 2, 40.72727272727273, 20.363636363636363, 20.363636363636363
2024-04-22 15:22:00.528827, 3044, 1523, 1521, 2, 40.72727272727273, 20.363636363636363, 20.363636363636363
2024-04-22 15:22:03.279589, 3154, 1578, 1576, 2, 40.0, 20.0, 20.0
2024-04-22 15:22:06.030282, 3264, 1633, 1631, 2, 40.0, 20.0, 20.0
2024-04-22 15:22:08.780862, 3378, 1690, 1688, 2, 41.45454545454545, 20.727272727272727, 20.727272727272727
2024-04-22 15:22:11.532283, 3378, 1690, 1688, 2, 0.0, 0.0, 0.0
2024-04-22 15:22:14.283807, 3378, 1690, 1688, 2, 0.0, 0.0, 0.0
2024-04-22 15:22:17.034696, 3382, 1693, 1689, 4, 1.4545454545454546, 1.0909090909090908, 0.36363636363636365
2024-04-22 15:22:19.785696, 3384, 1694, 1690, 0, 0.7272727272727273, 0.36363636363636365, 0.36363636363636365
2024-04-22 15:22:22.536496, 3384, 1694, 1690, 0, 0.0, 0.0, 0.0
2024-04-22 15:22:25.287186, 3388, 1696, 1692, 0, 1.4545454545454546, 0.7272727272727273, 0.7272727272727273
2024-04-22 15:22:28.037667, 3388, 1696, 1692, 0, 0.0, 0.0, 0.0
2024-04-22 15:22:30.788366, 3390, 1697, 1693, 0, 0.7272727272727273, 0.36363636363636365, 0.36363636363636365
2024-04-22 15:22:33.538909, 3392, 1698, 1694, 0, 0.7272727272727273, 0.36363636363636365, 0.36363636363636365
2024-04-22 15:22:36.289890, 3392, 1698, 1694, 0, 0.0, 0.0, 0.0
2024-04-22 15:22:39.040520, 3394, 1699, 1695, 0, 0.7272727272727273, 0.36363636363636365, 0.36363636363636365
2024-04-22 15:22:41.791023, 3396, 1700, 1696, 0, 0.7272727272727273, 0.36363636363636365, 0.36363636363636365
2024-04-22 15:22:44.541747, 3396, 1700, 1696, 0, 0.0, 0.0, 0.0
2024-04-22 15:22:47.292578, 3396, 1700, 1696, 0, 0.0, 0.0, 0.0
2024-04-22 15:22:50.043425, 3400, 1703, 1697, 2, 1.4545454545454546, 1.0909090909090908, 0.36363636363636365
2024-04-22 15:22:52.794249, 3402, 1704, 1698, 0, 0.7272727272727273, 0.36363636363636365, 0.36363636363636365
2024-04-22 15:22:55.545384, 3402, 1704, 1698, 0, 0.0, 0.0, 0.0
2024-04-22 15:22:58.296487, 3406, 1706, 1700, 0, 1.4545454545454546, 0.7272727272727273, 0.7272727272727273
2024-04-22 15:23:01.047340, 3412, 1709, 1703, 0, 2.1818181818181817, 1.0909090909090908, 1.0909090909090908
2024-04-22 15:23:03.798240, 3552, 1779, 1773, 0, 50.90909090909091, 25.454545454545453, 25.454545454545453
2024-04-22 15:23:06.548931, 3666, 1836, 1830, 0, 41.45454545454545, 20.727272727272727, 20.727272727272727
2024-04-22 15:23:09.299419, 3776, 1891, 1885, 0, 40.0, 20.0, 20.0
2024-04-22 15:23:12.050252, 3886, 1946, 1940, 0, 40.0, 20.0, 20.0
2024-04-22 15:23:14.801341, 4000, 2003, 1997, 0, 41.45454545454545, 20.727272727272727, 20.727272727272727
2024-04-22 15:23:17.552425, 4110, 2058, 2052, 0, 40.0, 20.0, 20.0
2024-04-22 15:23:20.303214, 4220, 2113, 2107, 0, 40.0, 20.0, 20.0
2024-04-22 15:23:23.054042, 4334, 2170, 2164, 0, 41.45454545454545, 20.727272727272727, 20.727272727272727
2024-04-22 15:23:25.804928, 4434, 2220, 2214, 0, 36.36363636363637, 18.181818181818183, 18.181818181818183
2024-04-22 15:23:28.555656, 4434, 2220, 2214, 0, 0.0, 0.0, 0.0
2024-04-22 15:23:31.306179, 4438, 2222, 2216, 0, 1.4545454545454546, 0.7272727272727273, 0.7272727272727273
2024-04-22 15:23:34.056788, 4438, 2222, 2216, 0, 0.0, 0.0, 0.0
2024-04-22 15:23:36.807851, 4438, 2222, 2216, 0, 0.0, 0.0, 0.0
2024-04-22 15:23:39.559045, 4442, 2224, 2218, 0, 1.4545454545454546, 0.7272727272727273, 0.7272727272727273
2024-04-22 15:23:42.310117, 4442, 2224, 2218, 0, 0.0, 0.0, 0.0
2024-04-22 15:23:45.060852, 4442, 2224, 2218, 0, 0.0, 0.0, 0.0
2024-04-22 15:23:47.811814, 4516, 2262, 2254, 2, 26.90909090909091, 13.818181818181818, 13.090909090909092
2024-04-22 15:23:50.562468, 4590, 2299, 2291, 2, 26.90909090909091, 13.454545454545455, 13.454545454545455
2024-04-22 15:23:53.313182, 4662, 2335, 2327, 2, 26.181818181818183, 13.090909090909092, 13.090909090909092
2024-04-22 15:23:56.064839, 4738, 2373, 2365, 2, 27.636363636363637, 13.818181818181818, 13.818181818181818
2024-04-22 15:23:58.816298, 4774, 2391, 2383, 2, 13.090909090909092, 6.545454545454546, 6.545454545454546
2024-04-22 15:24:01.567528, 4774, 2391, 2383, 2, 0.0, 0.0, 0.0
2024-04-22 15:24:04.318720, 4778, 2393, 2385, 2, 1.4545454545454546, 0.7272727272727273, 0.7272727272727273
2024-04-22 15:24:07.069857, 4778, 2393, 2385, 2, 0.0, 0.0, 0.0
2024-04-22 15:24:09.820694, 4780, 2394, 2386, 0, 0.7272727272727273, 0.36363636363636365, 0.36363636363636365
2024-04-22 15:24:12.571335, 4782, 2395, 2387, 0, 0.7272727272727273, 0.36363636363636365, 0.36363636363636365
2024-04-22 15:24:15.321907, 7782, 3395, 4387, 1000, 1090.909090909091, 363.6363636363636, 727.2727272727273
2024-04-22 15:24:18.072984, 7782, 3395, 4387, 1000, 0.0, 0.0, 0.0
2024-04-22 15:24:20.824097, 7786, 3398, 4388, 1002, 1.4545454545454546, 1.0909090909090908, 0.36363636363636365
2024-04-22 15:24:23.575400, 7788, 3399, 4389, 0, 0.7272727272727273, 0.36363636363636365, 0.36363636363636365
2024-04-22 15:24:26.326601, 7788, 3399, 4389, 0, 0.0, 0.0, 0.0
2024-04-22 15:24:29.077529, 7792, 3401, 4391, 0, 1.4545454545454546, 0.7272727272727273, 0.7272727272727273
2024-04-22 15:24:31.828226, 7792, 3401, 4391, 0, 0.0, 0.0, 0.0
2024-04-22 15:24:34.578740, 7792, 3401, 4391, 0, 0.0, 0.0, 0.0
2024-04-22 15:24:37.329482, 7796, 3403, 4393, 0, 1.4545454545454546, 0.7272727272727273, 0.7272727272727273
2024-04-22 15:24:40.080353, 7796, 3403, 4393, 0, 0.0, 0.0, 0.0
2024-04-22 15:24:42.831338, 7800, 3405, 4395, 0, 1.4545454545454546, 0.7272727272727273, 0.7272727272727273
2024-04-22 15:24:45.582490, 7800, 3405, 4395, 0, 0.0, 0.0, 0.0
2024-04-22 15:24:48.333695, 7800, 3405, 4395, 0, 0.0, 0.0, 0.0
2024-04-22 15:24:51.084531, 7922, 3466, 4456, 0, 44.36363636363637, 22.181818181818183, 22.181818181818183
2024-04-22 15:24:53.835154, 8473, 3742, 4731, 1, 200.36363636363637, 100.36363636363636, 100.0
2024-04-22 15:24:56.585606, 9024, 4017, 5007, 2, 200.36363636363637, 100.0, 100.36363636363636
2024-04-22 15:24:59.336559, 9564, 4287, 5277, 2, 196.36363636363637, 98.18181818181819, 98.18181818181819
2024-04-22 15:25:02.087669, 10128, 4569, 5559, 2, 205.0909090909091, 102.54545454545455, 102.54545454545455
2024-04-22 15:25:04.838821, 10668, 4839, 5829, 2, 196.36363636363637, 98.18181818181819, 98.18181818181819
2024-04-22 15:25:07.589689, 11224, 5117, 6107, 2, 202.1818181818182, 101.0909090909091, 101.0909090909091
2024-04-22 15:25:10.340641, 11772, 5391, 6381, 2, 199.27272727272728, 99.63636363636364, 99.63636363636364
2024-04-22 15:25:13.091634, 11812, 5411, 6401, 2, 14.545454545454545, 7.2727272727272725, 7.2727272727272725
2024-04-22 15:25:15.842408, 11812, 5411, 6401, 2, 0.0, 0.0, 0.0
2024-04-22 15:25:18.593505, 11816, 5413, 6403, 2, 1.4545454545454546, 0.7272727272727273, 0.7272727272727273
2024-04-22 15:25:21.344876, 11816, 5413, 6403, 2, 0.0, 0.0, 0.0
2024-04-22 15:25:24.096112, 11816, 5413, 6403, 2, 0.0, 0.0, 0.0
2024-04-22 15:25:26.847078, 11820, 5415, 6405, 2, 1.4545454545454546, 0.7272727272727273, 0.7272727272727273
2024-04-22 15:25:29.598027, 11820, 5415, 6405, 2, 0.0, 0.0, 0.0
2024-04-22 15:25:32.349047, 11820, 5415, 6405, 2, 0.0, 0.0, 0.0
2024-04-22 15:25:35.100015, 11824, 5417, 6407, 2, 1.4545454545454546, 0.7272727272727273, 0.7272727272727273
2024-04-22 15:25:37.850835, 11824, 5417, 6407, 2, 0.0, 0.0, 0.0
2024-04-22 15:25:40.601984, 11824, 5417, 6407, 2, 0.0, 0.0, 0.0
2024-04-22 15:25:43.353031, 11828, 5419, 6409, 2, 1.4545454545454546, 0.7272727272727273, 0.7272727272727273
2024-04-22 15:25:46.104138, 11828, 5419, 6409, 2, 0.0, 0.0, 0.0
2024-04-22 15:25:48.855197, 11830, 5420, 6410, 0, 0.7272727272727273, 0.36363636363636365, 0.36363636363636365
2024-04-22 15:25:51.606284, 11832, 5421, 6411, 0, 0.7272727272727273, 0.36363636363636365, 0.36363636363636365
2024-04-22 15:25:54.356969, 11832, 5421, 6411, 0, 0.0, 0.0, 0.0
2024-04-22 15:25:57.107512, 11832, 5421, 6411, 0, 0.0, 0.0, 0.0
2024-04-22 15:25:59.858654, 11836, 5424, 6412, 2, 1.4545454545454546, 1.0909090909090908, 0.36363636363636365
2024-04-22 15:26:02.609639, 11838, 5425, 6413, 0, 0.7272727272727273, 0.36363636363636365, 0.36363636363636365
2024-04-22 15:26:05.360332, 11838, 5425, 6413, 0, 0.0, 0.0, 0.0
2024-04-22 15:26:08.110879, 11842, 5427, 6415, 0, 1.4545454545454546, 0.7272727272727273, 0.7272727272727273
2024-04-22 15:26:10.861604, 11842, 5427, 6415, 0, 0.0, 0.0, 0.0
2024-04-22 15:26:13.612084, 11842, 5427, 6415, 0, 0.0, 0.0, 0.0
2024-04-22 15:26:16.363866, 11846, 5430, 6416, 2, 1.4545454545454546, 1.0909090909090908, 0.36363636363636365
2024-04-22 15:26:19.115177, 11848, 5431, 6417, 0, 0.7272727272727273, 0.36363636363636365, 0.36363636363636365
2024-04-22 15:26:21.865826, 11850, 5432, 6418, 0, 0.7272727272727273, 0.36363636363636365, 0.36363636363636365
2024-04-22 15:26:24.616713, 11852, 5433, 6419, 0, 0.7272727272727273, 0.36363636363636365, 0.36363636363636365
2024-04-22 15:26:27.367179, 11852, 5433, 6419, 0, 0.0, 0.0, 0.0
2024-04-22 15:26:30.117890, 11852, 5433, 6419, 0, 0.0, 0.0, 0.0
2024-04-22 15:26:32.868898, 11856, 5435, 6421, 0, 1.4545454545454546, 0.7272727272727273, 0.7272727272727273
2024-04-22 15:26:35.619544, 11856, 5435, 6421, 0, 0.0, 0.0, 0.0
2024-04-22 15:26:38.370300, 11856, 5435, 6421, 0, 0.0, 0.0, 0.0
2024-04-22 15:26:41.120975, 11860, 5438, 6422, 2, 1.4545454545454546, 1.0909090909090908, 0.36363636363636365
2024-04-22 15:26:43.871862, 11862, 5439, 6423, 0, 0.7272727272727273, 0.36363636363636365, 0.36363636363636365
2024-04-22 15:26:46.622677, 11862, 5439, 6423, 0, 0.0, 0.0, 0.0
2024-04-22 15:26:49.375912, 11866, 5441, 6425, 0, 1.4545454545454546, 0.7272727272727273, 0.7272727272727273
2024-04-22 15:26:52.126919, 11866, 5441, 6425, 0, 0.0, 0.0, 0.0
2024-04-22 15:26:54.877844, 11870, 5443, 6427, 0, 1.4545454545454546, 0.7272727272727273, 0.7272727272727273
2024-04-22 15:26:57.628584, 11870, 5443, 6427, 0, 0.0, 0.0, 0.0
2024-04-22 15:27:00.379061, 11870, 5443, 6427, 0, 0.0, 0.0, 0.0
2024-04-22 15:27:03.130077, 11872, 5444, 6428, 0, 0.7272727272727273, 0.36363636363636365, 0.36363636363636365
2024-04-22 15:27:05.881001, 11874, 5445, 6429, 0, 0.7272727272727273, 0.36363636363636365, 0.36363636363636365
2024-04-22 15:27:08.631878, 11874, 5445, 6429, 0, 0.0, 0.0, 0.0
2024-04-22 15:27:11.382671, 11874, 5445, 6429, 0, 0.0, 0.0, 0.0
2024-04-22 15:27:14.133379, 11878, 5447, 6431, 0, 1.4545454545454546, 0.7272727272727273, 0.7272727272727273
2024-04-22 15:27:16.884098, 11878, 5447, 6431, 0, 0.0, 0.0, 0.0
2024-04-22 15:27:19.634997, 11878, 5447, 6431, 0, 0.0, 0.0, 0.0
2024-04-22 15:27:22.386064, 11882, 5450, 6432, 2, 1.4545454545454546, 1.0909090909090908, 0.36363636363636365
2024-04-22 15:27:25.136908, 11884, 5451, 6433, 0, 0.7272727272727273, 0.36363636363636365, 0.36363636363636365
2024-04-22 15:27:27.888017, 11884, 5451, 6433, 0, 0.0, 0.0, 0.0
2024-04-22 15:27:30.638889, 11888, 5453, 6435, 0, 1.4545454545454546, 0.7272727272727273, 0.7272727272727273
2024-04-22 15:27:33.389929, 11888, 5453, 6435, 0, 0.0, 0.0, 0.0
2024-04-22 15:27:36.140834, 11888, 5453, 6435, 0, 0.0, 0.0, 0.0
2024-04-22 15:27:38.891908, 11892, 5455, 6437, 0, 1.4545454545454546, 0.7272727272727273, 0.7272727272727273
2024-04-22 15:27:41.642916, 11892, 5455, 6437, 0, 0.0, 0.0, 0.0
2024-04-22 15:27:44.393622, 11892, 5455, 6437, 0, 0.0, 0.0, 0.0
2024-04-22 15:27:47.144581, 11896, 5457, 6439, 0, 1.4545454545454546, 0.7272727272727273, 0.7272727272727273
2024-04-22 15:27:49.895627, 11896, 5457, 6439, 0, 0.0, 0.0, 0.0
2024-04-22 15:27:52.646453, 11896, 5457, 6439, 0, 0.0, 0.0, 0.0
2024-04-22 15:27:55.396980, 11900, 5459, 6441, 0, 1.4545454545454546, 0.7272727272727273, 0.7272727272727273
2024-04-22 15:27:58.147553, 11981, 5486, 6495, 27, 29.454545454545453, 9.818181818181818, 19.636363636363637
2024-04-22 15:28:00.898386, 12808, 5762, 7046, 302, 300.72727272727275, 100.36363636363636, 200.36363636363637
2024-04-22 15:28:03.648890, 13635, 6038, 7597, 577, 300.72727272727275, 100.36363636363636, 200.36363636363637
2024-04-22 15:28:06.399741, 14413, 6301, 8112, 829, 282.90909090909093, 95.63636363636364, 187.27272727272728
2024-04-22 15:28:09.150751, 14693, 6441, 8252, 829, 101.81818181818181, 50.90909090909091, 50.90909090909091
2024-04-22 15:28:11.901819, 14751, 6470, 8281, 829, 21.09090909090909, 10.545454545454545, 10.545454545454545
2024-04-22 15:28:14.652552, 14807, 6498, 8309, 829, 20.363636363636363, 10.181818181818182, 10.181818181818182
2024-04-22 15:28:17.403204, 14861, 6525, 8336, 829, 19.636363636363637, 9.818181818181818, 9.818181818181818
2024-04-22 15:28:20.154336, 14877, 6534, 8343, 831, 5.818181818181818, 3.272727272727273, 2.5454545454545454
2024-04-22 15:28:22.905700, 14879, 6535, 8344, 0, 0.7272727272727273, 0.36363636363636365, 0.36363636363636365
2024-04-22 15:28:25.657097, 14879, 6535, 8344, 0, 0.0, 0.0, 0.0
2024-04-22 15:28:28.408355, 14883, 6538, 8345, 2, 1.4545454545454546, 1.0909090909090908, 0.36363636363636365
2024-04-22 15:28:31.159058, 14885, 6539, 8346, 0, 0.7272727272727273, 0.36363636363636365, 0.36363636363636365
2024-04-22 15:28:33.909948, 14887, 6540, 8347, 0, 0.7272727272727273, 0.36363636363636365, 0.36363636363636365
2024-04-22 15:28:36.660583, 14889, 6541, 8348, 0, 0.7272727272727273, 0.36363636363636365, 0.36363636363636365
2024-04-22 15:28:39.411125, 14889, 6541, 8348, 0, 0.0, 0.0, 0.0
2024-04-22 15:28:42.162038, 14889, 6541, 8348, 0, 0.0, 0.0, 0.0
2024-04-22 15:28:44.913101, 14893, 6543, 8350, 0, 1.4545454545454546, 0.7272727272727273, 0.7272727272727273
2024-04-22 15:28:47.664109, 14893, 6543, 8350, 0, 0.0, 0.0, 0.0
2024-04-22 15:28:50.415246, 14893, 6543, 8350, 0, 0.0, 0.0, 0.0
2024-04-22 15:28:53.166353, 14897, 6546, 8351, 2, 1.4545454545454546, 1.0909090909090908, 0.36363636363636365
2024-04-22 15:28:55.917359, 14899, 6547, 8352, 0, 0.7272727272727273, 0.36363636363636365, 0.36363636363636365
2024-04-22 15:28:58.668055, 14901, 6548, 8353, 0, 0.7272727272727273, 0.36363636363636365, 0.36363636363636365
2024-04-22 15:29:01.419211, 14903, 6549, 8354, 0, 0.7272727272727273, 0.36363636363636365, 0.36363636363636365
2024-04-22 15:29:04.170529, 14903, 6549, 8354, 0, 0.0, 0.0, 0.0
2024-04-22 15:29:06.921361, 14907, 6551, 8356, 0, 1.4545454545454546, 0.7272727272727273, 0.7272727272727273
2024-04-22 15:29:09.672241, 14907, 6551, 8356, 0, 0.0, 0.0, 0.0
2024-04-22 15:29:12.423165, 14907, 6551, 8356, 0, 0.0, 0.0, 0.0
2024-04-22 15:29:15.174295, 14909, 6552, 8357, 0, 0.7272727272727273, 0.36363636363636365, 0.36363636363636365
2024-04-22 15:29:17.925121, 14911, 6553, 8358, 0, 0.7272727272727273, 0.36363636363636365, 0.36363636363636365
2024-04-22 15:29:20.675733, 14911, 6553, 8358, 0, 0.0, 0.0, 0.0
2024-04-22 15:29:23.426879, 14911, 6553, 8358, 0, 0.0, 0.0, 0.0
2024-04-22 15:29:26.177813, 14915, 6556, 8359, 2, 1.4545454545454546, 1.0909090909090908, 0.36363636363636365
2024-04-22 15:29:28.928415, 15100, 6618, 8482, 63, 67.27272727272727, 22.545454545454547, 44.72727272727273
2024-04-22 15:29:31.679154, 15511, 6755, 8756, 200, 149.45454545454547, 49.81818181818182, 99.63636363636364
2024-04-22 15:29:34.429807, 15929, 6895, 9034, 338, 152.0, 50.90909090909091, 101.0909090909091
2024-04-22 15:29:37.182542, 16229, 7029, 9200, 370, 109.0909090909091, 48.72727272727273, 60.36363636363637
2024-04-22 15:29:39.942105, 16355, 7068, 9287, 418, 45.81818181818182, 14.181818181818182, 31.636363636363637
2024-04-22 15:29:42.692671, 16413, 7097, 9316, 418, 21.09090909090909, 10.545454545454545, 10.545454545454545
2024-04-22 15:29:45.443564, 16469, 7125, 9344, 418, 20.363636363636363, 10.181818181818182, 10.181818181818182
2024-04-22 15:29:48.194770, 16523, 7152, 9371, 418, 19.636363636363637, 9.818181818181818, 9.818181818181818
2024-04-22 15:29:50.945951, 16583, 7183, 9400, 420, 21.818181818181817, 11.272727272727273, 10.545454545454545
2024-04-22 15:29:53.696995, 16639, 7211, 9428, 420, 20.363636363636363, 10.181818181818182, 10.181818181818182
2024-04-22 15:29:56.447949, 16695, 7239, 9456, 420, 20.363636363636363, 10.181818181818182, 10.181818181818182
2024-04-22 15:29:59.198717, 16753, 7268, 9485, 420, 21.09090909090909, 10.545454545454545, 10.545454545454545
2024-04-22 15:30:01.949301, 16807, 7295, 9512, 420, 19.636363636363637, 9.818181818181818, 9.818181818181818
2024-04-22 15:30:04.700194, 16863, 7323, 9540, 420, 20.363636363636363, 10.181818181818182, 10.181818181818182
2024-04-22 15:30:07.450862, 16921, 7353, 9568, 422, 21.09090909090909, 10.909090909090908, 10.181818181818182
2024-04-22 15:30:10.201523, 16979, 7382, 9597, 422, 21.09090909090909, 10.545454545454545, 10.545454545454545
2024-04-22 15:30:12.952723, 17035, 7410, 9625, 422, 20.363636363636363, 10.181818181818182, 10.181818181818182
2024-04-22 15:30:15.703576, 17093, 7439, 9654, 422, 21.09090909090909, 10.545454545454545, 10.545454545454545
2024-04-22 15:30:18.454540, 17113, 7449, 9664, 422, 7.2727272727272725, 3.6363636363636362, 3.6363636363636362
2024-04-22 15:30:21.205214, 17113, 7449, 9664, 422, 0.0, 0.0, 0.0
2024-04-22 15:30:23.955660, 17117, 7451, 9666, 422, 1.4545454545454546, 0.7272727272727273, 0.7272727272727273
2024-04-22 15:30:26.706861, 17117, 7451, 9666, 422, 0.0, 0.0, 0.0
2024-04-22 15:30:29.458114, 17117, 7451, 9666, 422, 0.0, 0.0, 0.0
2024-04-22 15:30:32.208851, 17121, 7454, 9667, 424, 1.4545454545454546, 1.0909090909090908, 0.36363636363636365
2024-04-22 15:30:34.959606, 17123, 7455, 9668, 0, 0.7272727272727273, 0.36363636363636365, 0.36363636363636365
2024-04-22 15:30:37.710243, 17123, 7455, 9668, 0, 0.0, 0.0, 0.0
2024-04-22 15:30:40.460710, 17127, 7457, 9670, 0, 1.4545454545454546, 0.7272727272727273, 0.7272727272727273
2024-04-22 15:30:43.211228, 17127, 7457, 9670, 0, 0.0, 0.0, 0.0
2024-04-22 15:30:45.962558, 17129, 7458, 9671, 0, 0.7272727272727273, 0.36363636363636365, 0.36363636363636365
2024-04-22 15:30:48.713921, 17131, 7459, 9672, 0, 0.7272727272727273, 0.36363636363636365, 0.36363636363636365
2024-04-22 15:30:51.464911, 17131, 7459, 9672, 0, 0.0, 0.0, 0.0
2024-04-22 15:30:54.215639, 17131, 7459, 9672, 0, 0.0, 0.0, 0.0
2024-04-22 15:30:56.966621, 17135, 7461, 9674, 0, 1.4545454545454546, 0.7272727272727273, 0.7272727272727273
2024-04-22 15:30:59.717660, 17135, 7461, 9674, 0, 0.0, 0.0, 0.0
2024-04-22 15:31:02.468575, 17135, 7461, 9674, 0, 0.0, 0.0, 0.0
2024-04-22 15:31:05.219271, 17256, 7502, 9754, 39, 44.0, 14.909090909090908, 29.09090909090909
2024-04-22 15:31:07.969907, 17421, 7557, 9864, 94, 60.0, 20.0, 40.0
2024-04-22 15:31:10.720645, 17588, 7613, 9975, 149, 60.72727272727273, 20.363636363636363, 40.36363636363637
2024-04-22 15:31:13.471319, 17704, 7663, 10041, 165, 42.18181818181818, 18.181818181818183, 24.0
2024-04-22 15:31:16.222161, 17758, 7690, 10068, 165, 19.636363636363637, 9.818181818181818, 9.818181818181818
2024-04-22 15:31:18.973140, 17816, 7719, 10097, 165, 21.09090909090909, 10.545454545454545, 10.545454545454545
2024-04-22 15:31:21.724004, 17872, 7747, 10125, 165, 20.363636363636363, 10.181818181818182, 10.181818181818182
2024-04-22 15:31:24.474733, 17926, 7774, 10152, 165, 19.636363636363637, 9.818181818181818, 9.818181818181818
2024-04-22 15:31:27.225533, 17984, 7803, 10181, 165, 21.09090909090909, 10.545454545454545, 10.545454545454545
2024-04-22 15:31:29.976566, 18040, 7831, 10209, 165, 20.363636363636363, 10.181818181818182, 10.181818181818182
2024-04-22 15:31:32.727569, 18096, 7859, 10237, 165, 20.363636363636363, 10.181818181818182, 10.181818181818182
2024-04-22 15:31:35.478496, 18150, 7886, 10264, 165, 19.636363636363637, 9.818181818181818, 9.818181818181818
2024-04-22 15:31:38.229309, 18210, 7916, 10294, 165, 21.818181818181817, 10.909090909090908, 10.909090909090908
2024-04-22 15:31:40.979952, 18264, 7943, 10321, 165, 19.636363636363637, 9.818181818181818, 9.818181818181818
2024-04-22 15:31:43.730636, 18318, 7970, 10348, 165, 19.636363636363637, 9.818181818181818, 9.818181818181818
2024-04-22 15:31:46.481450, 18378, 8000, 10378, 165, 21.818181818181817, 10.909090909090908, 10.909090909090908
2024-04-22 15:31:49.232417, 18432, 8027, 10405, 165, 19.636363636363637, 9.818181818181818, 9.818181818181818
2024-04-22 15:31:51.983312, 18488, 8055, 10433, 165, 20.363636363636363, 10.181818181818182, 10.181818181818182
2024-04-22 15:31:54.734003, 18546, 8085, 10461, 167, 21.09090909090909, 10.909090909090908, 10.181818181818182
2024-04-22 15:31:57.484885, 18604, 8114, 10490, 167, 21.09090909090909, 10.545454545454545, 10.545454545454545
2024-04-22 15:32:00.235369, 18658, 8141, 10517, 167, 19.636363636363637, 9.818181818181818, 9.818181818181818
2024-04-22 15:32:02.985881, 18716, 8171, 10545, 169, 21.09090909090909, 10.909090909090908, 10.181818181818182
2024-04-22 15:32:05.736609, 18774, 8200, 10574, 169, 21.09090909090909, 10.545454545454545, 10.545454545454545
2024-04-22 15:32:08.487393, 18830, 8228, 10602, 169, 20.363636363636363, 10.181818181818182, 10.181818181818182
2024-04-22 15:32:11.238218, 18888, 8258, 10630, 171, 21.09090909090909, 10.909090909090908, 10.181818181818182
2024-04-22 15:32:13.989023, 18944, 8286, 10658, 171, 20.363636363636363, 10.181818181818182, 10.181818181818182
2024-04-22 15:32:16.739667, 19000, 8314, 10686, 171, 20.363636363636363, 10.181818181818182, 10.181818181818182
2024-04-22 15:32:19.490335, 19058, 8343, 10715, 171, 21.09090909090909, 10.545454545454545, 10.545454545454545
2024-04-22 15:32:22.241035, 19114, 8371, 10743, 171, 20.363636363636363, 10.181818181818182, 10.181818181818182
2024-04-22 15:32:24.991683, 19170, 8399, 10771, 171, 20.363636363636363, 10.181818181818182, 10.181818181818182
2024-04-22 15:32:27.742345, 19228, 8428, 10800, 171, 21.09090909090909, 10.545454545454545, 10.545454545454545
2024-04-22 15:32:30.492945, 19282, 8455, 10827, 171, 19.636363636363637, 9.818181818181818, 9.818181818181818
2024-04-22 15:32:33.243665, 19336, 8482, 10854, 171, 19.636363636363637, 9.818181818181818, 9.818181818181818
2024-04-22 15:32:35.994383, 19397, 8513, 10884, 172, 22.181818181818183, 11.272727272727273, 10.909090909090908
2024-04-22 15:32:38.744972, 19451, 8540, 10911, 172, 19.636363636363637, 9.818181818181818, 9.818181818181818
2024-04-22 15:32:41.495612, 19508, 8569, 10939, 173, 20.727272727272727, 10.545454545454545, 10.181818181818182
2024-04-22 15:32:44.246088, 19566, 8598, 10968, 173, 21.09090909090909, 10.545454545454545, 10.545454545454545
2024-04-22 15:32:46.996773, 19622, 8626, 10996, 173, 20.363636363636363, 10.181818181818182, 10.181818181818182
2024-04-22 15:32:49.747779, 19676, 8653, 11023, 173, 19.636363636363637, 9.818181818181818, 9.818181818181818
2024-04-22 15:32:52.499651, 19736, 8684, 11052, 175, 21.818181818181817, 11.272727272727273, 10.545454545454545
2024-04-22 15:32:55.250572, 19792, 8712, 11080, 175, 20.363636363636363, 10.181818181818182, 10.181818181818182
2024-04-22 15:32:58.002041, 19848, 8740, 11108, 175, 20.363636363636363, 10.181818181818182, 10.181818181818182
2024-04-22 15:33:00.752914, 19906, 8769, 11137, 175, 21.09090909090909, 10.545454545454545, 10.545454545454545
2024-04-22 15:33:03.505096, 19960, 8796, 11164, 175, 19.636363636363637, 9.818181818181818, 9.818181818181818
2024-04-22 15:33:06.258276, 19990, 8824, 11166, 201, 10.909090909090908, 10.181818181818182, 0.7272727272727273
2024-04-22 15:33:09.009024, 20019, 8853, 11166, 230, 10.545454545454545, 10.545454545454545, 0.0
2024-04-22 15:33:11.759942, 20046, 8880, 11166, 257, 9.818181818181818, 9.818181818181818, 0.0
2024-04-22 15:33:14.510705, 20074, 8908, 11166, 285, 10.181818181818182, 10.181818181818182, 0.0
2024-04-22 15:33:17.261672, 20101, 8935, 11166, 312, 9.818181818181818, 9.818181818181818, 0.0
2024-04-22 15:33:20.012453, 20131, 8965, 11166, 342, 10.909090909090908, 10.909090909090908, 0.0
2024-04-22 15:33:22.762960, 20154, 8988, 11166, 365, 8.363636363636363, 8.363636363636363, 0.0
2024-04-22 15:33:25.513482, 20155, 8989, 11166, 365, 0.36363636363636365, 0.36363636363636365, 0.0
2024-04-22 15:33:28.264353, 20156, 8990, 11166, 365, 0.36363636363636365, 0.36363636363636365, 0.0
2024-04-22 15:33:31.015515, 20156, 8990, 11166, 365, 0.0, 0.0, 0.0
2024-04-22 15:33:33.766309, 20157, 8991, 11166, 365, 0.36363636363636365, 0.36363636363636365, 0.0
2024-04-22 15:33:36.517069, 20158, 8992, 11166, 365, 0.36363636363636365, 0.36363636363636365, 0.0
2024-04-22 15:33:39.268161, 20158, 8992, 11166, 365, 0.0, 0.0, 0.0
2024-04-22 15:33:42.019439, 20158, 8992, 11166, 365, 0.0, 0.0, 0.0
2024-04-22 15:33:44.770365, 20159, 8993, 11166, 365, 0.36363636363636365, 0.36363636363636365, 0.0
2024-04-22 15:33:47.521196, 20159, 8993, 11166, 365, 0.0, 0.0, 0.0
2024-04-22 15:33:50.272309, 20159, 8993, 11166, 365, 0.0, 0.0, 0.0
2024-04-22 15:33:53.023489, 20159, 8993, 11166, 365, 0.0, 0.0, 0.0
2024-04-22 15:33:55.774398, 20159, 8993, 11166, 365, 0.0, 0.0, 0.0
2024-04-22 15:33:58.525618, 20159, 8993, 11166, 365, 0.0, 0.0, 0.0
2024-04-22 15:34:01.276560, 20159, 8993, 11166, 365, 0.0, 0.0, 0.0
2024-04-22 15:34:04.027303, 20159, 8993, 11166, 365, 0.0, 0.0, 0.0
2024-04-22 15:34:06.778188, 20159, 8993, 11166, 365, 0.0, 0.0, 0.0
2024-04-22 15:34:09.529395, 20159, 8993, 11166, 365, 0.0, 0.0, 0.0
2024-04-22 15:34:12.280682, 20159, 8993, 11166, 365, 0.0, 0.0, 0.0
2024-04-22 15:34:15.031796, 20159, 8993, 11166, 365, 0.0, 0.0, 0.0
2024-04-22 15:34:17.783049, 20159, 8993, 11166, 365, 0.0, 0.0, 0.0
2024-04-22 15:34:20.534385, 20159, 8993, 11166, 365, 0.0, 0.0, 0.0
2024-04-22 15:34:23.285600, 20159, 8993, 11166, 365, 0.0, 0.0, 0.0
2024-04-22 15:34:26.036769, 20159, 8993, 11166, 365, 0.0, 0.0, 0.0
2024-04-22 15:34:28.787970, 20159, 8993, 11166, 365, 0.0, 0.0, 0.0
2024-04-22 15:34:31.539535, 20159, 8993, 11166, 365, 0.0, 0.0, 0.0
2024-04-22 15:34:34.290561, 20159, 8993, 11166, 365, 0.0, 0.0, 0.0
2024-04-22 15:34:37.041917, 20159, 8993, 11166, 365, 0.0, 0.0, 0.0
2024-04-22 15:34:39.793163, 20159, 8993, 11166, 365, 0.0, 0.0, 0.0
2024-04-22 15:34:42.544673, 20159, 8993, 11166, 365, 0.0, 0.0, 0.0
2024-04-22 15:34:45.295881, 20159, 8993, 11166, 365, 0.0, 0.0, 0.0
2024-04-22 15:34:48.046879, 20159, 8993, 11166, 365, 0.0, 0.0, 0.0
2024-04-22 15:34:50.798369, 20159, 8993, 11166, 365, 0.0, 0.0, 0.0
2024-04-22 15:34:53.549802, 20159, 8993, 11166, 365, 0.0, 0.0, 0.0
2024-04-22 15:34:56.300584, 20159, 8993, 11166, 365, 0.0, 0.0, 0.0
2024-04-22 15:34:59.051845, 20159, 8993, 11166, 365, 0.0, 0.0, 0.0
2024-04-22 15:35:01.802784, 20159, 8993, 11166, 365, 0.0, 0.0, 0.0
2024-04-22 15:35:04.554120, 20159, 8993, 11166, 365, 0.0, 0.0, 0.0
2024-04-22 15:35:07.304833, 20159, 8993, 11166, 365, 0.0, 0.0, 0.0
2024-04-22 15:35:10.055496, 20159, 8993, 11166, 365, 0.0, 0.0, 0.0
2024-04-22 15:35:12.805985, 20159, 8993, 11166, 365, 0.0, 0.0, 0.0
2024-04-22 15:35:15.556592, 20159, 8993, 11166, 365, 0.0, 0.0, 0.0
2024-04-22 15:35:18.307434, 20159, 8993, 11166, 365, 0.0, 0.0, 0.0
2024-04-22 15:35:21.058557, 20159, 8993, 11166, 365, 0.0, 0.0, 0.0
2024-04-22 15:35:23.809948, 20159, 8993, 11166, 365, 0.0, 0.0, 0.0
2024-04-22 15:35:26.561136, 20159, 8993, 11166, 365, 0.0, 0.0, 0.0
2024-04-22 15:35:29.312044, 20159, 8993, 11166, 365, 0.0, 0.0, 0.0
2024-04-22 15:35:32.062802, 20159, 8993, 11166, 365, 0.0, 0.0, 0.0
2024-04-22 15:35:34.813814, 20159, 8993, 11166, 365, 0.0, 0.0, 0.0
2024-04-22 15:35:37.564592, 20159, 8993, 11166, 365, 0.0, 0.0, 0.0
2024-04-22 15:35:40.315613, 20159, 8993, 11166, 365, 0.0, 0.0, 0.0
2024-04-22 15:35:43.066776, 20159, 8993, 11166, 365, 0.0, 0.0, 0.0
2024-04-22 15:35:45.817816, 20159, 8993, 11166, 365, 0.0, 0.0, 0.0
2024-04-22 15:35:48.569033, 20159, 8993, 11166, 365, 0.0, 0.0, 0.0
2024-04-22 15:35:51.319863, 20159, 8993, 11166, 365, 0.0, 0.0, 0.0
2024-04-22 15:35:54.071154, 20159, 8993, 11166, 365, 0.0, 0.0, 0.0
2024-04-22 15:35:56.822625, 20159, 8993, 11166, 365, 0.0, 0.0, 0.0
2024-04-22 15:35:59.573973, 20159, 8993, 11166, 365, 0.0, 0.0, 0.0
2024-04-22 15:36:02.325208, 20159, 8993, 11166, 365, 0.0, 0.0, 0.0
2024-04-22 15:36:05.076388, 20159, 8993, 11166, 365, 0.0, 0.0, 0.0
2024-04-22 15:36:07.827634, 20159, 8993, 11166, 365, 0.0, 0.0, 0.0
2024-04-22 15:36:10.578821, 20159, 8993, 11166, 365, 0.0, 0.0, 0.0
2024-04-22 15:36:13.330085, 20159, 8993, 11166, 365, 0.0, 0.0, 0.0
2024-04-22 15:36:16.081264, 20159, 8993, 11166, 365, 0.0, 0.0, 0.0
2024-04-22 15:36:18.832896, 20159, 8993, 11166, 365, 0.0, 0.0, 0.0
2024-04-22 15:36:21.584008, 20159, 8993, 11166, 365, 0.0, 0.0, 0.0
2024-04-22 15:36:24.334731, 20159, 8993, 11166, 365, 0.0, 0.0, 0.0
2024-04-22 15:36:27.085630, 20159, 8993, 11166, 365, 0.0, 0.0, 0.0
2024-04-22 15:36:29.836677, 20159, 8993, 11166, 365, 0.0, 0.0, 0.0
2024-04-22 15:36:32.587675, 20159, 8993, 11166, 365, 0.0, 0.0, 0.0
2024-04-22 15:36:35.338667, 20159, 8993, 11166, 365, 0.0, 0.0, 0.0
2024-04-22 15:36:38.089756, 20159, 8993, 11166, 365, 0.0, 0.0, 0.0
2024-04-22 15:36:40.840967, 20159, 8993, 11166, 365, 0.0, 0.0, 0.0
2024-04-22 15:36:43.591870, 20159, 8993, 11166, 365, 0.0, 0.0, 0.0
2024-04-22 15:36:46.343060, 20159, 8993, 11166, 365, 0.0, 0.0, 0.0
2024-04-22 15:36:49.094705, 20159, 8993, 11166, 365, 0.0, 0.0, 0.0
2024-04-22 15:36:51.845943, 20159, 8993, 11166, 365, 0.0, 0.0, 0.0
2024-04-22 15:36:54.597334, 20159, 8993, 11166, 365, 0.0, 0.0, 0.0
2024-04-22 15:36:57.348640, 20159, 8993, 11166, 365, 0.0, 0.0, 0.0
2024-04-22 15:37:00.099953, 20159, 8993, 11166, 365, 0.0, 0.0, 0.0
2024-04-22 15:37:02.851038, 20159, 8993, 11166, 365, 0.0, 0.0, 0.0
2024-04-22 15:37:05.602248, 20159, 8993, 11166, 365, 0.0, 0.0, 0.0
2024-04-22 15:37:08.353439, 20159, 8993, 11166, 365, 0.0, 0.0, 0.0
2024-04-22 15:37:11.104150, 20159, 8993, 11166, 365, 0.0, 0.0, 0.0
2024-04-22 15:37:13.854973, 20159, 8993, 11166, 365, 0.0, 0.0, 0.0
2024-04-22 15:37:16.605882, 20159, 8993, 11166, 365, 0.0, 0.0, 0.0
2024-04-22 15:37:19.357132, 20159, 8993, 11166, 365, 0.0, 0.0, 0.0
2024-04-22 15:37:22.108431, 20159, 8993, 11166, 365, 0.0, 0.0, 0.0
2024-04-22 15:37:24.859335, 20159, 8993, 11166, 365, 0.0, 0.0, 0.0
2024-04-22 15:37:27.610160, 20159, 8993, 11166, 365, 0.0, 0.0, 0.0
2024-04-22 15:37:30.361137, 20159, 8993, 11166, 365, 0.0, 0.0, 0.0
2024-04-22 15:37:33.111934, 20159, 8993, 11166, 365, 0.0, 0.0, 0.0
2024-04-22 15:37:35.862915, 20159, 8993, 11166, 365, 0.0, 0.0, 0.0
2024-04-22 15:37:38.614179, 20159, 8993, 11166, 365, 0.0, 0.0, 0.0
2024-04-22 15:37:41.365382, 20159, 8993, 11166, 365, 0.0, 0.0, 0.0
2024-04-22 15:37:44.116490, 20159, 8993, 11166, 365, 0.0, 0.0, 0.0
2024-04-22 15:37:46.867231, 20159, 8993, 11166, 365, 0.0, 0.0, 0.0
2024-04-22 15:37:49.617698, 20159, 8993, 11166, 365, 0.0, 0.0, 0.0
2024-04-22 15:37:52.368543, 20159, 8993, 11166, 365, 0.0, 0.0, 0.0
2024-04-22 15:37:55.119739, 20159, 8993, 11166, 365, 0.0, 0.0, 0.0
2024-04-22 15:37:57.871053, 20159, 8993, 11166, 365, 0.0, 0.0, 0.0
2024-04-22 15:38:00.622381, 20159, 8993, 11166, 365, 0.0, 0.0, 0.0
2024-04-22 15:38:03.373724, 20159, 8993, 11166, 365, 0.0, 0.0, 0.0
2024-04-22 15:38:06.124825, 20159, 8993, 11166, 365, 0.0, 0.0, 0.0
2024-04-22 15:38:08.876053, 20159, 8993, 11166, 365, 0.0, 0.0, 0.0
2024-04-22 15:38:11.627350, 20159, 8993, 11166, 365, 0.0, 0.0, 0.0
2024-04-22 15:38:14.378245, 20159, 8993, 11166, 365, 0.0, 0.0, 0.0
2024-04-22 15:38:17.129126, 20159, 8993, 11166, 365, 0.0, 0.0, 0.0
2024-04-22 15:38:19.880073, 20159, 8993, 11166, 365, 0.0, 0.0, 0.0
2024-04-22 15:38:22.631147, 20159, 8993, 11166, 365, 0.0, 0.0, 0.0
2024-04-22 15:38:25.381915, 20159, 8993, 11166, 365, 0.0, 0.0, 0.0
2024-04-22 15:38:28.132899, 20159, 8993, 11166, 365, 0.0, 0.0, 0.0
2024-04-22 15:38:30.883854, 20159, 8993, 11166, 365, 0.0, 0.0, 0.0
2024-04-22 15:38:33.634857, 20159, 8993, 11166, 365, 0.0, 0.0, 0.0
2024-04-22 15:38:36.385888, 20159, 8993, 11166, 365, 0.0, 0.0, 0.0
2024-04-22 15:38:39.136765, 20159, 8993, 11166, 365, 0.0, 0.0, 0.0
2024-04-22 15:38:41.887687, 20159, 8993, 11166, 365, 0.0, 0.0, 0.0
2024-04-22 15:38:44.638795, 20159, 8993, 11166, 365, 0.0, 0.0, 0.0
2024-04-22 15:38:47.389726, 20159, 8993, 11166, 365, 0.0, 0.0, 0.0
2024-04-22 15:38:50.140646, 20159, 8993, 11166, 365, 0.0, 0.0, 0.0
2024-04-22 15:38:52.891625, 20159, 8993, 11166, 365, 0.0, 0.0, 0.0
2024-04-22 15:38:55.642563, 20159, 8993, 11166, 365, 0.0, 0.0, 0.0
2024-04-22 15:38:58.393806, 20159, 8993, 11166, 365, 0.0, 0.0, 0.0
2024-04-22 15:39:01.144961, 20159, 8993, 11166, 365, 0.0, 0.0, 0.0
2024-04-22 15:39:03.896112, 20159, 8993, 11166, 365, 0.0, 0.0, 0.0
2024-04-22 15:39:06.647295, 20159, 8993, 11166, 365, 0.0, 0.0, 0.0
2024-04-22 15:39:09.398279, 20159, 8993, 11166, 365, 0.0, 0.0, 0.0
2024-04-22 15:39:12.149481, 20159, 8993, 11166, 365, 0.0, 0.0, 0.0
2024-04-22 15:39:14.900697, 20159, 8993, 11166, 365, 0.0, 0.0, 0.0
2024-04-22 15:39:17.652011, 20159, 8993, 11166, 365, 0.0, 0.0, 0.0
2024-04-22 15:39:20.403154, 20159, 8993, 11166, 365, 0.0, 0.0, 0.0
2024-04-22 15:39:23.154033, 20159, 8993, 11166, 365, 0.0, 0.0, 0.0
2024-04-22 15:39:25.904955, 20159, 8993, 11166, 365, 0.0, 0.0, 0.0
2024-04-22 15:39:28.656180, 20159, 8993, 11166, 365, 0.0, 0.0, 0.0
2024-04-22 15:39:31.407266, 20159, 8993, 11166, 365, 0.0, 0.0, 0.0
2024-04-22 15:39:34.158383, 20159, 8993, 11166, 365, 0.0, 0.0, 0.0
2024-04-22 15:39:36.909442, 20159, 8993, 11166, 365, 0.0, 0.0, 0.0
2024-04-22 15:39:39.660274, 20159, 8993, 11166, 365, 0.0, 0.0, 0.0
2024-04-22 15:39:42.411350, 20159, 8993, 11166, 365, 0.0, 0.0, 0.0
2024-04-22 15:39:45.162172, 20159, 8993, 11166, 365, 0.0, 0.0, 0.0
2024-04-22 15:39:47.913055, 20159, 8993, 11166, 365, 0.0, 0.0, 0.0
2024-04-22 15:39:50.664156, 20159, 8993, 11166, 365, 0.0, 0.0, 0.0
2024-04-22 15:39:53.415371, 20159, 8993, 11166, 365, 0.0, 0.0, 0.0
2024-04-22 15:39:56.166542, 20159, 8993, 11166, 365, 0.0, 0.0, 0.0
2024-04-22 15:39:58.917806, 20159, 8993, 11166, 365, 0.0, 0.0, 0.0
2024-04-22 15:40:01.669029, 20159, 8993, 11166, 365, 0.0, 0.0, 0.0
2024-04-22 15:40:04.420075, 20159, 8993, 11166, 365, 0.0, 0.0, 0.0
2024-04-22 15:40:07.170744, 20159, 8993, 11166, 365, 0.0, 0.0, 0.0
2024-04-22 15:40:09.921828, 20159, 8993, 11166, 365, 0.0, 0.0, 0.0
2024-04-22 15:40:12.672631, 20159, 8993, 11166, 365, 0.0, 0.0, 0.0
2024-04-22 15:40:15.423402, 20159, 8993, 11166, 365, 0.0, 0.0, 0.0
2024-04-22 15:40:18.174362, 20159, 8993, 11166, 365, 0.0, 0.0, 0.0
2024-04-22 15:40:20.925135, 20159, 8993, 11166, 365, 0.0, 0.0, 0.0
2024-04-22 15:40:23.675704, 20159, 8993, 11166, 365, 0.0, 0.0, 0.0
2024-04-22 15:40:26.426589, 20159, 8993, 11166, 365, 0.0, 0.0, 0.0
2024-04-22 15:40:29.177350, 20159, 8993, 11166, 365, 0.0, 0.0, 0.0
2024-04-22 15:40:31.928091, 20159, 8993, 11166, 365, 0.0, 0.0, 0.0
2024-04-22 15:40:34.679292, 20159, 8993, 11166, 365, 0.0, 0.0, 0.0
2024-04-22 15:40:37.430286, 20159, 8993, 11166, 365, 0.0, 0.0, 0.0
2024-04-22 15:40:40.181438, 20159, 8993, 11166, 365, 0.0, 0.0, 0.0
2024-04-22 15:40:42.932674, 20159, 8993, 11166, 365, 0.0, 0.0, 0.0
2024-04-22 15:40:45.683394, 20159, 8993, 11166, 365, 0.0, 0.0, 0.0
2024-04-22 15:40:48.434318, 20159, 8993, 11166, 365, 0.0, 0.0, 0.0
2024-04-22 15:40:51.185375, 20159, 8993, 11166, 365, 0.0, 0.0, 0.0
2024-04-22 15:40:53.936747, 20159, 8993, 11166, 365, 0.0, 0.0, 0.0
2024-04-22 15:40:56.687740, 20159, 8993, 11166, 365, 0.0, 0.0, 0.0
2024-04-22 15:40:59.438618, 20159, 8993, 11166, 365, 0.0, 0.0, 0.0
2024-04-22 15:41:02.189947, 20159, 8993, 11166, 365, 0.0, 0.0, 0.0
2024-04-22 15:41:04.941134, 20159, 8993, 11166, 365, 0.0, 0.0, 0.0
2024-04-22 15:41:07.692396, 20159, 8993, 11166, 365, 0.0, 0.0, 0.0
2024-04-22 15:41:10.443274, 20159, 8993, 11166, 365, 0.0, 0.0, 0.0
2024-04-22 15:41:13.194382, 20159, 8993, 11166, 365, 0.0, 0.0, 0.0
2024-04-22 15:41:15.945265, 20159, 8993, 11166, 365, 0.0, 0.0, 0.0
2024-04-22 15:41:18.696265, 20159, 8993, 11166, 365, 0.0, 0.0, 0.0
2024-04-22 15:41:21.447188, 20159, 8993, 11166, 365, 0.0, 0.0, 0.0
2024-04-22 15:41:24.198321, 20159, 8993, 11166, 365, 0.0, 0.0, 0.0
2024-04-22 15:41:26.949154, 20159, 8993, 11166, 365, 0.0, 0.0, 0.0
2024-04-22 15:41:29.700110, 20159, 8993, 11166, 365, 0.0, 0.0, 0.0
2024-04-22 15:41:32.451095, 20159, 8993, 11166, 365, 0.0, 0.0, 0.0
2024-04-22 15:41:35.202180, 20159, 8993, 11166, 365, 0.0, 0.0, 0.0
2024-04-22 15:41:37.953303, 20159, 8993, 11166, 365, 0.0, 0.0, 0.0
2024-04-22 15:41:40.704621, 20159, 8993, 11166, 365, 0.0, 0.0, 0.0
2024-04-22 15:41:43.455698, 20159, 8993, 11166, 365, 0.0, 0.0, 0.0
2024-04-22 15:41:46.206514, 20159, 8993, 11166, 365, 0.0, 0.0, 0.0
2024-04-22 15:41:48.957681, 20159, 8993, 11166, 365, 0.0, 0.0, 0.0
2024-04-22 15:41:51.708606, 20159, 8993, 11166, 365, 0.0, 0.0, 0.0
2024-04-22 15:41:54.459666, 20159, 8993, 11166, 365, 0.0, 0.0, 0.0
2024-04-22 15:41:57.210481, 20159, 8993, 11166, 365, 0.0, 0.0, 0.0
2024-04-22 15:41:59.961320, 20159, 8993, 11166, 365, 0.0, 0.0, 0.0
2024-04-22 15:42:02.712520, 20159, 8993, 11166, 365, 0.0, 0.0, 0.0
2024-04-22 15:42:05.463809, 20159, 8993, 11166, 365, 0.0, 0.0, 0.0
2024-04-22 15:42:08.215027, 20159, 8993, 11166, 365, 0.0, 0.0, 0.0
2024-04-22 15:42:10.966500, 20159, 8993, 11166, 365, 0.0, 0.0, 0.0
2024-04-22 15:42:13.717195, 20159, 8993, 11166, 365, 0.0, 0.0, 0.0
2024-04-22 15:42:16.468038, 20159, 8993, 11166, 365, 0.0, 0.0, 0.0
2024-04-22 15:42:19.219025, 20159, 8993, 11166, 365, 0.0, 0.0, 0.0
2024-04-22 15:42:21.969686, 20159, 8993, 11166, 365, 0.0, 0.0, 0.0
2024-04-22 15:42:24.720333, 20159, 8993, 11166, 365, 0.0, 0.0, 0.0
2024-04-22 15:42:27.471266, 20159, 8993, 11166, 365, 0.0, 0.0, 0.0
2024-04-22 15:42:30.222210, 20159, 8993, 11166, 365, 0.0, 0.0, 0.0
2024-04-22 15:42:32.973158, 20159, 8993, 11166, 365, 0.0, 0.0, 0.0
2024-04-22 15:42:35.724068, 20159, 8993, 11166, 365, 0.0, 0.0, 0.0
2024-04-22 15:42:38.475210, 20159, 8993, 11166, 365, 0.0, 0.0, 0.0
2024-04-22 15:42:41.226257, 20159, 8993, 11166, 365, 0.0, 0.0, 0.0
2024-04-22 15:42:43.977284, 20159, 8993, 11166, 365, 0.0, 0.0, 0.0
2024-04-22 15:42:46.728433, 20159, 8993, 11166, 365, 0.0, 0.0, 0.0
2024-04-22 15:42:49.479636, 20159, 8993, 11166, 365, 0.0, 0.0, 0.0
2024-04-22 15:42:52.230783, 20159, 8993, 11166, 365, 0.0, 0.0, 0.0
2024-04-22 15:42:54.982243, 20159, 8993, 11166, 365, 0.0, 0.0, 0.0
2024-04-22 15:42:57.733713, 20159, 8993, 11166, 365, 0.0, 0.0, 0.0
2024-04-22 15:43:00.484941, 20159, 8993, 11166, 365, 0.0, 0.0, 0.0
2024-04-22 15:43:03.236006, 20159, 8993, 11166, 365, 0.0, 0.0, 0.0
2024-04-22 15:43:05.987225, 20159, 8993, 11166, 365, 0.0, 0.0, 0.0
2024-04-22 15:43:08.738682, 20159, 8993, 11166, 365, 0.0, 0.0, 0.0
2024-04-22 15:43:11.490114, 20159, 8993, 11166, 365, 0.0, 0.0, 0.0
2024-04-22 15:43:14.241452, 20159, 8993, 11166, 365, 0.0, 0.0, 0.0
2024-04-22 15:43:16.992833, 20159, 8993, 11166, 365, 0.0, 0.0, 0.0
2024-04-22 15:43:19.744229, 20159, 8993, 11166, 365, 0.0, 0.0, 0.0
2024-04-22 15:43:22.495447, 20159, 8993, 11166, 365, 0.0, 0.0, 0.0
2024-04-22 15:43:25.247135, 20159, 8993, 11166, 365, 0.0, 0.0, 0.0
2024-04-22 15:43:27.998322, 20159, 8993, 11166, 365, 0.0, 0.0, 0.0
2024-04-22 15:43:30.749794, 20159, 8993, 11166, 365, 0.0, 0.0, 0.0
2024-04-22 15:43:33.500994, 20159, 8993, 11166, 365, 0.0, 0.0, 0.0
2024-04-22 15:43:36.252172, 20159, 8993, 11166, 365, 0.0, 0.0, 0.0
2024-04-22 15:43:39.003039, 20159, 8993, 11166, 365, 0.0, 0.0, 0.0
2024-04-22 15:43:41.754222, 20159, 8993, 11166, 365, 0.0, 0.0, 0.0
2024-04-22 15:43:44.505107, 20159, 8993, 11166, 365, 0.0, 0.0, 0.0
2024-04-22 15:43:47.255975, 20159, 8993, 11166, 365, 0.0, 0.0, 0.0
2024-04-22 15:43:50.006983, 20159, 8993, 11166, 365, 0.0, 0.0, 0.0
2024-04-22 15:43:52.758146, 20159, 8993, 11166, 365, 0.0, 0.0, 0.0
2024-04-22 15:43:55.509189, 20159, 8993, 11166, 365, 0.0, 0.0, 0.0
2024-04-22 15:43:58.260066, 20159, 8993, 11166, 365, 0.0, 0.0, 0.0
2024-04-22 15:44:01.010958, 20159, 8993, 11166, 365, 0.0, 0.0, 0.0
2024-04-22 15:44:03.762067, 20159, 8993, 11166, 365, 0.0, 0.0, 0.0
2024-04-22 15:44:06.513096, 20159, 8993, 11166, 365, 0.0, 0.0, 0.0
2024-04-22 15:44:09.264061, 20159, 8993, 11166, 365, 0.0, 0.0, 0.0
2024-04-22 15:44:12.014967, 20159, 8993, 11166, 365, 0.0, 0.0, 0.0
2024-04-22 15:44:14.765890, 20159, 8993, 11166, 365, 0.0, 0.0, 0.0
2024-04-22 15:44:17.516798, 20159, 8993, 11166, 365, 0.0, 0.0, 0.0
2024-04-22 15:44:20.267777, 20159, 8993, 11166, 365, 0.0, 0.0, 0.0
2024-04-22 15:44:23.018648, 20159, 8993, 11166, 365, 0.0, 0.0, 0.0
2024-04-22 15:44:25.769452, 20159, 8993, 11166, 365, 0.0, 0.0, 0.0
2024-04-22 15:44:28.520430, 20159, 8993, 11166, 365, 0.0, 0.0, 0.0
2024-04-22 15:44:31.271264, 20159, 8993, 11166, 365, 0.0, 0.0, 0.0
2024-04-22 15:44:34.021818, 20159, 8993, 11166, 365, 0.0, 0.0, 0.0
2024-04-22 15:44:36.772276, 20159, 8993, 11166, 365, 0.0, 0.0, 0.0
2024-04-22 15:44:39.522930, 20159, 8993, 11166, 365, 0.0, 0.0, 0.0
2024-04-22 15:44:42.274078, 20159, 8993, 11166, 365, 0.0, 0.0, 0.0
2024-04-22 15:44:45.024925, 20159, 8993, 11166, 365, 0.0, 0.0, 0.0
2024-04-22 15:44:47.776932, 20159, 8993, 11166, 365, 0.0, 0.0, 0.0
2024-04-22 15:44:50.527797, 20159, 8993, 11166, 365, 0.0, 0.0, 0.0
2024-04-22 15:44:53.278769, 20159, 8993, 11166, 365, 0.0, 0.0, 0.0
2024-04-22 15:44:56.030168, 20159, 8993, 11166, 365, 0.0, 0.0, 0.0
2024-04-22 15:44:58.781463, 20159, 8993, 11166, 365, 0.0, 0.0, 0.0
2024-04-22 15:45:01.532885, 20159, 8993, 11166, 365, 0.0, 0.0, 0.0
2024-04-22 15:45:04.284304, 20159, 8993, 11166, 365, 0.0, 0.0, 0.0
2024-04-22 15:45:07.035669, 20159, 8993, 11166, 365, 0.0, 0.0, 0.0
2024-04-22 15:45:09.786798, 20159, 8993, 11166, 365, 0.0, 0.0, 0.0
2024-04-22 15:45:12.537911, 20159, 8993, 11166, 365, 0.0, 0.0, 0.0
2024-04-22 15:45:15.288835, 20159, 8993, 11166, 365, 0.0, 0.0, 0.0
2024-04-22 15:45:18.040020, 20159, 8993, 11166, 365, 0.0, 0.0, 0.0
2024-04-22 15:45:20.791165, 20159, 8993, 11166, 365, 0.0, 0.0, 0.0
2024-04-22 15:45:23.542381, 20159, 8993, 11166, 365, 0.0, 0.0, 0.0
2024-04-22 15:45:26.293850, 20159, 8993, 11166, 365, 0.0, 0.0, 0.0
2024-04-22 15:45:29.044881, 20159, 8993, 11166, 365, 0.0, 0.0, 0.0
2024-04-22 15:45:31.796151, 20159, 8993, 11166, 365, 0.0, 0.0, 0.0
2024-04-22 15:45:34.547278, 20159, 8993, 11166, 365, 0.0, 0.0, 0.0
2024-04-22 15:45:37.298383, 20159, 8993, 11166, 365, 0.0, 0.0, 0.0
2024-04-22 15:45:40.049533, 20159, 8993, 11166, 365, 0.0, 0.0, 0.0
2024-04-22 15:45:42.800592, 20159, 8993, 11166, 365, 0.0, 0.0, 0.0
2024-04-22 15:45:45.551293, 20159, 8993, 11166, 365, 0.0, 0.0, 0.0
2024-04-22 15:45:48.302685, 20159, 8993, 11166, 365, 0.0, 0.0, 0.0
2024-04-22 15:45:51.053896, 20159, 8993, 11166, 365, 0.0, 0.0, 0.0
2024-04-22 15:45:53.804870, 20159, 8993, 11166, 365, 0.0, 0.0, 0.0
2024-04-22 15:45:56.556026, 20159, 8993, 11166, 365, 0.0, 0.0, 0.0
2024-04-22 15:45:59.307023, 20159, 8993, 11166, 365, 0.0, 0.0, 0.0
2024-04-22 15:46:02.057905, 20159, 8993, 11166, 365, 0.0, 0.0, 0.0
2024-04-22 15:46:04.808619, 20159, 8993, 11166, 365, 0.0, 0.0, 0.0
2024-04-22 15:46:07.559749, 20159, 8993, 11166, 365, 0.0, 0.0, 0.0
2024-04-22 15:46:10.310864, 20159, 8993, 11166, 365, 0.0, 0.0, 0.0
2024-04-22 15:46:13.061894, 20159, 8993, 11166, 365, 0.0, 0.0, 0.0
2024-04-22 15:46:15.812803, 20159, 8993, 11166, 365, 0.0, 0.0, 0.0
2024-04-22 15:46:18.564216, 20159, 8993, 11166, 365, 0.0, 0.0, 0.0
2024-04-22 15:46:21.315175, 20159, 8993, 11166, 365, 0.0, 0.0, 0.0
2024-04-22 15:46:24.066216, 20159, 8993, 11166, 365, 0.0, 0.0, 0.0
2024-04-22 15:46:26.817464, 20159, 8993, 11166, 365, 0.0, 0.0, 0.0
2024-04-22 15:46:29.568860, 20159, 8993, 11166, 365, 0.0, 0.0, 0.0
2024-04-22 15:46:32.320096, 20159, 8993, 11166, 365, 0.0, 0.0, 0.0
2024-04-22 15:46:35.071290, 20159, 8993, 11166, 365, 0.0, 0.0, 0.0
2024-04-22 15:46:37.822287, 20159, 8993, 11166, 365, 0.0, 0.0, 0.0
2024-04-22 15:46:40.573429, 20159, 8993, 11166, 365, 0.0, 0.0, 0.0
2024-04-22 15:46:43.324661, 20159, 8993, 11166, 365, 0.0, 0.0, 0.0
2024-04-22 15:46:46.075560, 20159, 8993, 11166, 365, 0.0, 0.0, 0.0
2024-04-22 15:46:48.826606, 20159, 8993, 11166, 365, 0.0, 0.0, 0.0
2024-04-22 15:46:51.577780, 20159, 8993, 11166, 365, 0.0, 0.0, 0.0
2024-04-22 15:46:54.328396, 20159, 8993, 11166, 365, 0.0, 0.0, 0.0
2024-04-22 15:46:57.079042, 20159, 8993, 11166, 365, 0.0, 0.0, 0.0
2024-04-22 15:46:59.830101, 20159, 8993, 11166, 365, 0.0, 0.0, 0.0
2024-04-22 15:47:02.581262, 20159, 8993, 11166, 365, 0.0, 0.0, 0.0
2024-04-22 15:47:05.332605, 20159, 8993, 11166, 365, 0.0, 0.0, 0.0
2024-04-22 15:47:08.083709, 20159, 8993, 11166, 365, 0.0, 0.0, 0.0
2024-04-22 15:47:10.834877, 20159, 8993, 11166, 365, 0.0, 0.0, 0.0
2024-04-22 15:47:13.586170, 20159, 8993, 11166, 365, 0.0, 0.0, 0.0
2024-04-22 15:47:16.337307, 20159, 8993, 11166, 365, 0.0, 0.0, 0.0
2024-04-22 15:47:19.088660, 20159, 8993, 11166, 365, 0.0, 0.0, 0.0
2024-04-22 15:47:21.840275, 20159, 8993, 11166, 365, 0.0, 0.0, 0.0
2024-04-22 15:47:24.591565, 20159, 8993, 11166, 365, 0.0, 0.0, 0.0
2024-04-22 15:47:27.342993, 20159, 8993, 11166, 365, 0.0, 0.0, 0.0
2024-04-22 15:47:30.094490, 20159, 8993, 11166, 365, 0.0, 0.0, 0.0
2024-04-22 15:47:32.846352, 20159, 8993, 11166, 365, 0.0, 0.0, 0.0
2024-04-22 15:47:35.598207, 20159, 8993, 11166, 365, 0.0, 0.0, 0.0
2024-04-22 15:47:38.349678, 20159, 8993, 11166, 365, 0.0, 0.0, 0.0
2024-04-22 15:47:41.100871, 20159, 8993, 11166, 365, 0.0, 0.0, 0.0
2024-04-22 15:47:43.852486, 20159, 8993, 11166, 365, 0.0, 0.0, 0.0
2024-04-22 15:47:46.603846, 20159, 8993, 11166, 365, 0.0, 0.0, 0.0
2024-04-22 15:47:49.354847, 20159, 8993, 11166, 365, 0.0, 0.0, 0.0
2024-04-22 15:47:52.105735, 20159, 8993, 11166, 365, 0.0, 0.0, 0.0
2024-04-22 15:47:54.856517, 20159, 8993, 11166, 365, 0.0, 0.0, 0.0
2024-04-22 15:47:57.607301, 20159, 8993, 11166, 365, 0.0, 0.0, 0.0
2024-04-22 15:48:00.358083, 20159, 8993, 11166, 365, 0.0, 0.0, 0.0
2024-04-22 15:48:03.108797, 20159, 8993, 11166, 365, 0.0, 0.0, 0.0
2024-04-22 15:48:05.859943, 20159, 8993, 11166, 365, 0.0, 0.0, 0.0
2024-04-22 15:48:08.610519, 20159, 8993, 11166, 365, 0.0, 0.0, 0.0
2024-04-22 15:48:11.361602, 20159, 8993, 11166, 365, 0.0, 0.0, 0.0
2024-04-22 15:48:14.112697, 20159, 8993, 11166, 365, 0.0, 0.0, 0.0
2024-04-22 15:48:16.863974, 20159, 8993, 11166, 365, 0.0, 0.0, 0.0
2024-04-22 15:48:19.614986, 20159, 8993, 11166, 365, 0.0, 0.0, 0.0
2024-04-22 15:48:22.366170, 20159, 8993, 11166, 365, 0.0, 0.0, 0.0
2024-04-22 15:48:25.117058, 20159, 8993, 11166, 365, 0.0, 0.0, 0.0
2024-04-22 15:48:27.868051, 20159, 8993, 11166, 365, 0.0, 0.0, 0.0
2024-04-22 15:48:30.618811, 20159, 8993, 11166, 365, 0.0, 0.0, 0.0
2024-04-22 15:48:33.369281, 20159, 8993, 11166, 365, 0.0, 0.0, 0.0
2024-04-22 15:48:36.119610, 20159, 8993, 11166, 365, 0.0, 0.0, 0.0
2024-04-22 15:48:38.870601, 20159, 8993, 11166, 365, 0.0, 0.0, 0.0
2024-04-22 15:48:41.621314, 20159, 8993, 11166, 365, 0.0, 0.0, 0.0
2024-04-22 15:48:44.371938, 20159, 8993, 11166, 365, 0.0, 0.0, 0.0
2024-04-22 15:48:47.122774, 20159, 8993, 11166, 365, 0.0, 0.0, 0.0
2024-04-22 15:48:49.873668, 20159, 8993, 11166, 365, 0.0, 0.0, 0.0
2024-04-22 15:48:52.624700, 20159, 8993, 11166, 365, 0.0, 0.0, 0.0
2024-04-22 15:48:55.375634, 20159, 8993, 11166, 365, 0.0, 0.0, 0.0
2024-04-22 15:48:58.126389, 20159, 8993, 11166, 365, 0.0, 0.0, 0.0
2024-04-22 15:49:00.877291, 20159, 8993, 11166, 365, 0.0, 0.0, 0.0
2024-04-22 15:49:03.628252, 20159, 8993, 11166, 365, 0.0, 0.0, 0.0
2024-04-22 15:49:06.379134, 20159, 8993, 11166, 365, 0.0, 0.0, 0.0
2024-04-22 15:49:09.130191, 20159, 8993, 11166, 365, 0.0, 0.0, 0.0
2024-04-22 15:49:11.881326, 20159, 8993, 11166, 365, 0.0, 0.0, 0.0
2024-04-22 15:49:14.632147, 20159, 8993, 11166, 365, 0.0, 0.0, 0.0
2024-04-22 15:49:17.382889, 20159, 8993, 11166, 365, 0.0, 0.0, 0.0
2024-04-22 15:49:20.133346, 20159, 8993, 11166, 365, 0.0, 0.0, 0.0
2024-04-22 15:49:22.883733, 20159, 8993, 11166, 365, 0.0, 0.0, 0.0
2024-04-22 15:49:25.634112, 20159, 8993, 11166, 365, 0.0, 0.0, 0.0
2024-04-22 15:49:28.384526, 20159, 8993, 11166, 365, 0.0, 0.0, 0.0
2024-04-22 15:49:31.134922, 20159, 8993, 11166, 365, 0.0, 0.0, 0.0
2024-04-22 15:49:33.885262, 20159, 8993, 11166, 365, 0.0, 0.0, 0.0
2024-04-22 15:49:36.635637, 20159, 8993, 11166, 365, 0.0, 0.0, 0.0
2024-04-22 15:49:39.386055, 20159, 8993, 11166, 365, 0.0, 0.0, 0.0
2024-04-22 15:49:42.136382, 20159, 8993, 11166, 365, 0.0, 0.0, 0.0
2024-04-22 15:49:44.886807, 20159, 8993, 11166, 365, 0.0, 0.0, 0.0
2024-04-22 15:49:47.637223, 20159, 8993, 11166, 365, 0.0, 0.0, 0.0
2024-04-22 15:49:50.387602, 20159, 8993, 11166, 365, 0.0, 0.0, 0.0
2024-04-22 15:49:53.137985, 20159, 8993, 11166, 365, 0.0, 0.0, 0.0
